переписать временные обозначения (дни недели, месяцы, времена года и пр.)

-----------------------

all`una - в час
fanno - делать
pasti - блюда (?)

-----------------------

colazione - завтрак
pranzo - обед
cena - ужин

-----------------------

pomeriggio - после полудня
mattina - утро
ancora - все еще (?)
tardi - поздно (?)
gente - люди (народ?)
sedia - стул
ogni - каждый
stanza - номер (?)

-----------------------

mette - помещать, класть
tovaglia - скатерть
piatto - блюдо(тарелка)
bicchiere - стакан
versa - nalivaet
mangia / mangiano - есть, ест / едят
pane - хлеб
formaggio - сыр
sala da pranzo - obedennaya komnata
beve - piyot

-----------------------

sulla - na
quello - что
oppure - или же
sopra - над
senza - без
soltano - tol`ko
invece - vmesto
sempre - vsegda
davanti - pered
molte volte - часто
sopra - sverhu
dove - gde

-----------------------

mano - ruka

allora - itak

--------------------------------------------------
Capitolo 10

Poco dopo - Вскоре после

fermano davanti - Остановились перед

negozio - магазин

Teresa ed Emma - ed - "и"

questa - это

paio - пара

guardare - смотреть

guanti - перчатки

E ce ne sono pure di verdi, di rossi e di bruni - 
А так же есть зеленые, красные и коричневые

E li - а там

quel - что 

Cos'e - что это 

mostra - показывает 

e allora - а после

prezzo - цена

piacciono - как они

dice - говорит 

pure - так же

trovi - ищешь

via - улица

cari - дорогие

migliore - лучший(лучше и т.п)

